7 7 7 7 7 7 7
7 7 5 7 7 5 7
5 5 7 7 7 7 7
7 7 7 5 5 7 7
7 5 7 7 8 7 7
7 5 5 5 7 7 7
7 7 7 7 7 7 7